1011181511111411111112
1000000000000000000002
10010S4002220002110102
1001006000220001000102
1001002510200045002102
0001000000200010000102
1002111100000000051102
1000000002222000001102
1511114022221140000102
1000000022220000000402
1021110522224110021102
1000000000000000000102
1000000000000000000102
1511117116222222200102
1511114116222222200502
1000000000000000000102
1000000000000000000502
1022222224111115141102
1022222225111110111102
0000000000000000000502
1000000000000000000102
1511114111111111110002
1000000000000000000102
1000000000000000000502
6021112222211111111102
1000000000000000001002
1000000000000000000E02
1511114115172221111312
