2222622222722222622222722222622222721111111111111111111111111
2000000000000000000000000000000000000000000000000000000000001
20S2422226222227211111000411111111111042222622222721111111101
2281000000000000000000000000000000001010000000000000000000001
1011111222262222272221101041111111111010221111151111111111101
1010000000000000000000001000000000000010100000000000000000001
1010221111151111111111104222262222272010221111151111111111101
1000100000000000000000001000000000001010000000000000000000001
1111111102222622222722211041111111111022111115222262222272101
1000000000000000000000001010000000001010000000000000000000001
1022111115222262222272101110411111111110102211111511111111101
1000100000000000000000010000100000000000100010000000000000001
1110221111151111111111022226222227222110111022226222227222101
1000000000000000000000000000000000000000010010000000000000001
1022111115222262222272101022111115111111111022226222227222101
1000000000000000000000000010000000000000001010000000000000001
2211111522226222227211100000221111151111111110422226222227201
1000000000000000000000000010100000000000000010100000000000001
1022111115222262222272111010222262222272221010104111112222201
1010000000000000000000010000100000000000000010100010000000001
1010221111152222622222721110221111151111111110101110111222201
1010000000000000000000000000000000000000000000100010000000001
1110422226222227211111111010422226222227211110111110111111101
1000000000001100000000010100000000000000000000000000000000001
1042222622222721001111111110422226222227211111111110122221101
10000000000000000000000000000000000000000000000000000000000E1
2222622222722222622222722222622222722222622222721111111111131
