2222222222222222222222222222222222222222222222222222222222222
2000000000000000000000000000000000000000000000000000000000002
80S0000000000000000000000000000000000000000000000000000000002
2000000000000000000000000000000000000000000000000000000000002
2000000000000000000000000000000000000000000000000000000000002
2000000000000000000000000000000000000000000000000000000000002
2000000050000000000022222222222222222222200000000060000000002
2000000050000000000022222222222222222222200000000060000000002
20000000500000000000228E0000000000022222200000000060000000002
2000000050000000000022222222222222022222200000000060000000002
2000000050000000000022222222220222022222200000000060000000002
2000000050000000000022222022220222022222200000000060000000002
2000000050000000000022200000000000022222200000000060000000002
2000000050000000000022202022000000000222200000000060000000002
2000000050000000000022002222022202220222200000000060000000002
2000000050000000000022022222022202220222200000000060000000002
2000000050000000000022022222002222220222200000000060000000002
2000000050000000000022000000022222220000000000000060000000002
2000000050000000000022222222222222222222200000000060000000002
2000000000000000000000000000000000000000000000000000000000002
2000100000000000000000000001000000000001000000000000001000002
2000100000000000000000000011000000000001000000000000001000002
2000100000000001110000000001000100000001000000000000001000002
2000100000000021110000000000000100000000000001000000001000002
2000100000000221110000000000000100000000000001000000001000002
2000000000002221110000000000000000000000000001000000000000002
2222222222222222222222222222222222222222222222222222222222222
