21151111141111111151141112
20000000000000000000000002
80S02000000000002000000102
22222000000000002000000402
10000000000000002000000102
10100002222222222200041102
10500002020202022000111102
50100002000000022000000502
10100000000200000000111102
10400000000200000000000102
10000001000000011000411102
40010001511011111141111102
11111151111014111511141102
10000000000000000000000402
11411001510002222222222102
11151001110002111411171102
10000000050002000001000102
40000000000002001005000102
10000000020002000001101102
10101000020000001000000102
10060000020001000001101102
10101000020001001004000502
1000000002000100000100E002
11141141511111451111113112
