0002222222222222222222222222222222222222222222222222222222222222222222222222222222222222222222222222222222222222222222222222222222222222222222222222222
80S0000000000000002002002002000000000002000000000002002000000000000002002002000002002000000000000000002000002002000000002000000000000000002000002000002
2002222222222222002002002002222222002002002002222002002222002222002222002002002222002222002222222002222222002002002222222222222002222222222222002002002
2000000000002000002000000000000000002002002000002002002000002000002000002000002000002000000000002002000000000000002000002002000002000002000002002002002
2002002222222222222002002222002002002002222002002222002002002222002002222002222002222002002002222002222222002002002002222002002002002002222002002002222
2002000000002000000002002002002002002000002002000000002002002000000002000000000002002002002000002000002000002002002000002002002000002002000000000000002
2222002002222222222222002002222222002222002002222222222002222222222222222222222002002222222002002222222002002222002002002002002222002002222002002222002
2000002000002002000000000000000002002002002002000002000002000000000000002000000002000002000002000000002002000002002002002000000002002002002002002002002
2002222002222002002222002002222222222002222002002002002222222002222222002002002222002002222002222222222002002002222002002002222222002222002002222002002
2000002000000002000002002000000000000000000002002002000000000000002000000002000000002000000000000002000002002000002002000002000000000000000000000002002
2222002222222002222222002222222002222002222002222002222002002222222222002222002002002222222002002002002222002222002002222222222222002222002222222222002
2000002002002002000000002000000002000000002002002000000002000000000002002000002002000002000002002000002002000002002002000000002000000002000002000002002
2222002002002002222222222002222222002222222222002222222002222222002222222002222002222222222222002222002002222002222222222222002002222002002222002222002
2000000000002002000002002000002000000002000000000000000002000002002000000002002000002000002002000002002000000002000000000000000002002002000002002000002
2002002222222222002222002222222222002222002222222222002002002002222222222222002222222002222002002002002222002222222222002222002002002222002222002002222
2002000002000002002002002000000002000000002000000002002000002002000000000002000000000000002002002002002002000002000000002000002002000000002000000000002
2002002222222002002002002222222002002222002222222002002002002222002002222002222002222222222002222002222002222222222222002002222222222222002222002222002
2002002000000002002000000000000000000002002002000000002002000000002002002002000000002002002002000002000002000002000000002000002000000000000002000002002
2222002222002222002222002002222222222222002002222222002222002222222222002002002002222002002002002222222002002002222222222222002002222222222222222222002
2002000002002000000000002000000000000002000002002000002002002002000002000000002000000002000000000000002000002000000000000002002000002000000000000000002
2002002222002002002222002222002222222222002002002222222002222002002002222002002222222222222002222222222222002222222222002222222222002222002002222222222
2000002002002002000002002000002000000002002002000002000002002000002002000002002000002000000000000002000000000000000002002000000000002000002002000000002
2002222002002002002002222222002002002222222222002002002002002002002222222002222002002222002222222222222002222222222222222222002222222002222002002222002
2000000000000002002002000002002002000000002000002000002000002002000002000000000002002000000000002000000000000002000002000002002000002002002002002000002
2002002002002222222222002222222002002222222222002222222002222002002222222002002222222002222002002222222002222222002222002222002222002222002002222222002
2002002002002000002000002002002002000000000002000002000000000002000002000002000002000002002002002000000002002000002002000000002000002000002000000000002
2002222222002222002222002002002222002002002222002222222002002222222002002002002222222002002002002002002222002002002002222222222002222222002002222002222
2000002002002000002002000002000002002002000000000002000002000000002000002002000002000000002002000002000002000002002000000000000000002000000002000002002
2222002002222002002002222002222002222002222222222222222222222222222002222222002222222222002222222222002002222002222222222002222222222002002222002002002
2002000002002002000000000002002000000000000002002000000002000002000000000002000000000002002000002002002000000002000000000000000002000002000002002000002
2002222002002002222002222222002002222002222222002002222222222002222222002222002222002222222222002002222002222222002222002222222222222002222002222222002
2000000000000000002000002002002002002000000000000002002000002002000002000002002000000000000000000002000002000000002002000000002002000002002000002000002
2002222222002222002222222002002222002002222002222002002222002002002222222222222222222222222222222002222002002222222002222222002002222002002222222222002
2000000002000002000000000000000002000000002002000002002000000002000002000002002000000000002000000002000000000000000000000002002000002002002000000002002
2002222002222002002222002222222002002222002222222002002222002222002222222002002222002222222002002002002222222222002222002222002002002002002002222002002
2000002002002002000002002000000002002000002000000000000002000000002000002000000002000002000002002002000002000000002002000002002002000000000002000002002
2002222222002222222222002222222002222222222002222002002222002222222002002002002222002002222222222222002222222002002002002002222002002002222222002222002
2000002000000000002002002000000000002000000002000002002000002000000002000002002000002002002002002002000002000002000002002000002002002002002000002000002
2002222222002002222002222002222222002222222222002222002222002222002002222222222222222002002002002002222222222222002222222222002222002222002222002222002
2002000000002002000000002000002000002000002002000002000002002000002000000000000000000002000000002000000000000000000002002000002000000002000002000002002
2002222222002002222002222222222002002002222002002002222222002222222002222002222002222222222222002002002002222222222002002002222222222002002002002222222
2002002000002000000002000000002002002002000002002002000000000002000002002000002002002002000002002002002000000002000000002000002000002000002002000000002
2002002002222222222002002222222002002002002222222222222002222002222222002222002002002002002002002002222222002222002222002002002222002222222222222222002
2000002002000000000002000002000002002000000002000002000000002000002000002000002000002002002000002000000002000002002000002002000000002000000000002000002
2002002002222222222222222002222222222002002002222002002222222222002222002222002222002002222002002222222002002002002222222002222002002222002002002002002
2002002000000002002002000002002002002002002002002000002000002000000002002000002000000000000002002000002002002002000002000002002002000000002002000002002
2002222222002222002002002222002002002222222002002222002222002222002222002222222222222002222002222002222222222222002222222002002222222222222222222002222
2002002000000000002002000000000002002000000002002000002000000002002002000000002000002002000000002002002000000000002000002000000000002000000002002002002
2002002222002002222002222002222002002222002222002222002002222222222002002222222002002002002002222002002002002222002222002222222002222222002222002222002
2000002000002000002000002000002002000000000000002000000000000000002000002002002002000002002002000000002002002000002000002000002000002000000000000000002
2222002002222222222002222222002222222002002002222222222222222002002222002002002002222222002222002002222222002222002222002222002222222222222002222222002
2002002002002000000000002000000000002002002000000002000000000002002000000000000000000002002000002002000002002000000000002000002000000000002002000000002
2002222002002222222222002002222002222222002222002002002222002002222222222222002222222222002002002222222002222222002002222222002222002222222222222002222
2000000002002000000000000002000000000000002000002000000002002000000000000002002000002000000002002000002002002000002002000000000002002000002000000000002
2222002002002222002222002002222222222222002222222222002222222222222222222222002222002222002222222002222002002002002222002002222002002002222222002222002
2000002002000000002000002002000002000000000000000002002000000000000002002000000000000002000000002000000002002002000000002002000002000002000000000002002
2002002002002002222222002222222002222002002002222222002222222222002002002002222222002222002222002002222002002222002002222222222002002002222002222002222
2002002002002002002000002000002000000002002000002002000000002000002000002002000000002000000002000002002002002000002000000000002002002002000002002000002
2002222002222002002222002222002002222002222002222002222222222222222222002002002222222002002002002002002222002222222002222222222002002002002002002002222
2002002000000002000000002000002002000000002002002002000002002000002000000002002000002002002002002000000002002000000002000002000002002002002002000002002
2222002002222002222222002002222222002222222222002002222002002222002002222002222002222222002222002222002002002002222222222002002002002002222002222222002
2000002002002002000000002000000002000002000000002000000002000000002002002002000000002000000002000002002000000002002000000002002002002000002002000002002
2002222222002002222222002002002222002222002222002222222002002222002002002222222002222002002222222222002222222002002002222002002222222222002002222002002
2000002000000002000002002002000002000000002000002000000002002000000000002000000000000002002000002000002000000002000000002002002000000002000000002002002
2002002002222222002222002002222002222222002002002222222002222002222002002002222222222222222222002222222002002222002222222222222222002002222222002002002
2002000000002000000000000000002002002002002002002000002000002002000002002002000002002000002000000002002002002000000000000000000002002000000000000000002
2002222222222222002222222002222222002002002222002002002002222222222222222002222002002222002002222222002222002002222002222002222002222222002222222002222
2000000002000002002002000002002000000002002000002002002002002000000000000002002000002000000000002002002000002000002000002000002002000000000002002000002
2002222222002222222002002002002222002002222002222002222002002002222222222002002002222222002002002002002002002002222222222002222222222002222222002222222
2000002000000000000000002002000000002000000000002002000000000000002002002002000000002000002002002002000002000000002002000000002002000000002002000000002
2222222222002002222222002222002222002222222002002002002002222002222002002002222002002002222222002002002002002002002002222222222002002222222002002222002
2002002000002002002002002002002000000002002002000002002002000000000002002000000002000000000002002000002002002002002000002000000000000002002002000002002
2002002002002222002002222002222222222222002222002002222222002222002002002002002222002002002222222002222222222002222222002222002222222002002002222002222
2000002002002000002000002000000000000000000000002002000000000002002000002002002002002002000000002002000002000000000000000002000000002002000000002000002
2222002222002002222002222222002002002222222002222222222222002222222222002002002002222222222222222222222002222002222222222222222002002222222002002222002
2000002002002000002000000002002002002000002002002000002000000002000002002002000002000002000002000000002000000002000000002000000002000000002002002000002
2002222002222002002222002222222002002002222002002002222222222002002002222002002222222002002222222002222222222002222222002002222222222002002002222002222
2000002000000002000000002000002002000002000000000000002000002002002002000002000000002000000000002000002002000000000000000002000002000002002000000000002
2002222002222002002002222002222002222002222222222002002002002222222002002002222002002002222222002002222002222222222002222222002222222222002002222002222
2000002000002002002002000002002002002000002000002002002002002000002002002002000002000000000002000002000002000002002002000002000002000000000000002000002
2222002222002002222222222002002002002222002002222222002222002222002002002222002002222222002002002222222002222002002002222002002002222002222222222222222
2000002000002000002000000000002000000002000002000002002002000002002000002002002000002002002002000002000000000002000000002002002000002002002000002000002
2002222002002222222222222222002002002222002222222002002002002222002002002002222002222002222002222222222002002002222222002002002002222002002222002222002
2000000002000002000000002002000002002000002000002002002000002000000002002002000002000002002000002002000002002000000000002000002002000000000000002000002
2002222222222002222002222002002222222222002222002002222222002002002002002002002002002002002222002002222222222222222222002002222222222222222002222002222
2000000000002000000000002002000000000002000000000000000002002002002002000002002002002002000000000002000000002000000000000000000002000002000000000002002
2222002222222002002222222002002222222002002222002222222222002002222002222002222222222002222222002002222002002222222222002002222222222002222002222222002
2000002000002002000000002000000000002002002000000000000000002000002000002002000000000000002000002000002002000000002000002000000000002000002000000000002
2222222002002222002222002002002222222222002222222002222222222222002222222002222222222222002002222222002222222002222002222222002222222002222222222222222
2002000002000002002000000002002000000000002002000002000002000000002002000000002002002000000002000000000002002000000002000000002002000002000002002000002
2002222002002002002222222002222222222222002002222002002222002222222002222222002002002002222222222222222002002222222222002222002002222002222002002002222
2000000002002000000002002002000000000000000002000000002000000000000000000002002000000000002000000000002002000002002000002000002000000002000000002002002
2002222002222222002002002222222002222002222222222002222002002222002222222002222222222002222222002222002222222002002222222222002002222002002222222002002
2002000002000002002000002000000002000002002002000002002002000002000002000002000000000000000000002002002000002000000000000002000002000000000002000000002
2002222002002222002002222222222002222002002002222002002002222222222002222222002002002222222002222002222002222222222002002222222002222222002002222002002
2000002002000002002000002000000002000000000002000002000002000002000002002002002002000000002000002000000000002002000002002000000000002000002002000002002
2222002222002002002222222222222002222222002002222002002222002002222002002002002222002002002002222002222002222002002222002222222222222222002002002222222
2000000002002000002002000002000002000000002002000000002000002000000002002000000002002002002002002002002000000002000002000002002000000000002000000000002
2222222002222222222002222002002222222002222222222222002222222002222002002002222222002002002002002002002222222002222002002222002002002222002002002222222
20000000000000020000000000000020000000000020000000000000020000000020020000000020000020020020000000020000000000000000020000000020020020000020020000000E8
2222222222222222222222222222222222222222222222222222222222222222222222222222222222222222222222222222222222222222222222222222222222222222222222222222200
