111111411115111611111111
8S00000000000000000003E1
122222222222014111151111
100100000000010000000011
100101411115110111111011
100000000000000611111011
222222722222041115111111
222222222222000000004111
222222222222222722201111
222222222222222222201111
222222222222222222201111
